#######
###P ##
### @##
# @@1##
# @11 #
# @11 #
#   ###
#######
