#########
#####  ##
###    ##
#   #  ##
#  @#@###
# @ @  ##
##1##  ##
#11  @ P#
# 11#   #
#########
