########
###   ##
#1# @ ##
#11@@ ##
#11#   #
#11@ #P#
# @ #  #
###@@ ##
###   ##
########
