#######
#   ###
# @   #
# @# P#
# @11 #
###11 #
####@ #
####  #
#######
