########
##P##11#
# @@ @1#
#   @  #
####  1#
########
