#######
###  ##
# @P11#
# # 11#
# #@###
# #   #
#   @ #
## @  #
##  ###
#######
