########
####111#
#P ##@ #
# @    #
## ##  #
##   #@#
####   #
########
