##########
######   #
# @ 11 @ #
#P@@11 @##
# @ 11  ##
##########