#######
###11##
##111##
## @ ##
# @ @##
# #@ ##
# # @ #
#     #
###P###
#######
