#######
#  ####
#    ##
# 1#@ #
## P  #
##1#@##
##   ##
#######